0000000000000000000000000000000000000000000000000000000000000000000000000000000000000000000000000000000000000000000000000000000000000000000000000000000000000000000000000000000000000000000000
0000000000000000000000000000000000000000000000000000000000000000000000000000000000000000000000000000000000000000000000000000000000000000000000000000000000000000000000000000000000000000000000
2000000000000000000000000000000000000000000000000000000000000000000000000000000000000000000000000000000000000000000000000000000000000000000000000000000000000000000000000000000000000000000000
1000000000000000000000000000000000000000000000000000000000000000000000000000000000000000000000000000000000000000000000000000000000000000000000000000000000000000000000000000000000000000000000
1000000000000000000000000000000000000000000000000000000000000000000000000000000000000000000000000000000000000000000000000000000000000000000000000000002000000000000000000000000000000000000000
1000000000000000000000000000000000000000000000000020020000000000000000000000000000000000000000000000000000000000000000000000000000000000000000000000021000000000000000000000000000000000000000
1000000000000000000000000000000000000000000000000210012000000000002200000000000000000000220002200002200000000000000000000000000000000000000000000000211000000000000000000000000000000000000000
1000000000000000000330000003300000000003300000002110011200000000000000000030003300000000000000000000000000000000030000000000033000330003300000000002111333000033300006000000000000000000000000
2222222222222222222220002222222200220222222222221110011122222222200002222222222222222220000000000000000022222222220002222222222222222222222220002221111222222222222222000000000000000000000000
1111111111111111111110001111111100110111111111111110011111111111100001111111111111111110000000000000000011111111110001111111111111111111111110001111111111111111111111000000000000000000000000
1111111111111111111115551111111155115111111111111115511111111111155551111111111111111115555555555555555511111111115551111111111111111111111115551111111111111111111111000000000000000000000000
1111111111111111111114441111111144114111111111111114411111111111144441111111111111111114444444444444444411111111114441111111111111111111111114441111111111111111111111555555555555555555555555
1111111111111111111114441111111144114111111111111114411111111111144441111111111111111114444444444444444411111111114441111111111111111111111114441111111111111111111111444444444444444444444444
1111111111111111111114441111111144114111111111111114411111111111144441111111111111111114444444444444444411111111114441111111111111111111111114441111111111111111111111444444444444444444444444