1000000000000000022200000000000000000000000000000000000000000000000000000000000000000000000000000000000000022200000000060000000000000000000000000000
1100000222220000000000002200000000000222220000000000000000000000000222220000000000000000000000000222220000000000000000110000000000000000000000000000
1100000000000000000000000000000000000100011100000000000000000000000000000000000000000000000000000000000000000000000000110000000000000000000000000000
2200000000000000022000000220000200000100000000022000000220002200000000000000022000000220002200000000000000000000000000110000000000000000000000000000
1100000000000002211000022112000122222222000002211333322112331122222222222222211333322112331122222100000000000000000001110000000000000000000000000000
1110000000000001000011111111100111000000000011111111111111111111111111111111111111111111111111111100000002220000000001110000000000000000000000000000
1111000033000001000111111111100000000000001111111111111111111444111111144444444111111111111111111111100000100000001111110000000000000000000000000000
1111111111111111111111111111100000000111111444111111111111111111111111144444444111111111111111111111115555155555551111115555555555555555555555555555
1111111111111111111111111111111111111111111111111111111111111111111111111111111111111111111111111111111111111111111111114444444444444444444444444444
1111111111111111111111111111111111111111111111111111111111111111111111111111111111111111111111111111111111111111111111114444444444444444444444444444
1111111111111111111111111111111111111111111111111111111111111111111111111111111111111111111111111111111111111111111111114444444444444444444444444444
1111111111111111111111111111111111111111111111111111111111111111111111111111111111111111111111111111111111111111111111114444444444444444444444444444
1111111111111111111111111111111111111111111111111111111111111111111111111111111111111111111111111111111111111111111111114444444444444444444444444444