000000000000000000000000000000000000000000000000000000000000000000000000000000000000000000000
000000000000000000000000000000000000000000000000000000000000000000000000000000000000000000000
000000000000000000000000000000000000000000000000000000000000000000000000000000000000000000000
000000000000000000000000000000000000000000000000000000000000000000000000000000000000000000000
000000000000000000000000000000000000000000000000000000000000000000000000000000000000000000000
200000000000000000000000000000000000000000000000000000000000000000000000000000000000000000000
100000000000000000000000000000000000000000000000000000000000000000000000000000000000000000000
100000000000000000000000000111111100001100001100000011011111110000000000000000000000000000000
100000000000000000000000000100000000010010001010000101010000000000000000000000000000000000000
100000000000000000000000000100011100100001001001001001011111000000000000000000000000000000000
100000000000000000000000000100000101111111101000110001010000000000000000000000006000000000000
155555111111111111111111110111111110000000011000000001011111111111111111111111111555555555555
144444444444444444444444444444444444444444444444444444444444444444444444444444444444444444444
144444444444444444444444444444444444444444444444444444444444444444444444444444444444444444444
144444444444444444444444444444444444444444444444444444444444444444444444444444444444444444444
144444444444444444444444444444444444444444444444444444444444444444444444444444444444444444444