000000000000000000000000000000000000000000000000000000000000000000000000000000000000000000000000000000000000000000000000000000000000000
000000000000000000000000000000000000000000000000000000000000000000000000000000000000000000000000000000000000000000000000000000000000000
000000000000000000000000000000000000000000000000000000000000000022200000000000000000000000000000000000000000000000000000000000000000000
000000000000000000000000000000333200000000000000000000000000000000000000000000000000000000000000022200000000000000000000000000000000000
000000022222000000000000000333222100000000000000000000000000000000000000000000222220000330000000000000000000000000000006000000000000000
000000000000000000000000000222000022000000000000000000000000000000000000000000000000000220000000000000000000000000000022000000000000000
220000000000000002200000022000000000000000000000000000000000000000000000000000000000000110000022233330000000000000002200000000000000000
112222222222222221100002211000000000002222222200222222222000022222222002222222222222222222222211111110000222222222221100000000000000000
111111111111111111100000000000000000001111110000111111100000011111111000000001111111111111111111111100000111111111111100000000000000000
111111111111111111100000000000111111111110010000111111100000111111111000000001111111111111111111111100000111111111111100000000000000000
111111111111111111100002222000111111111110000011111111100000111111111000000111111111111111111111111100000111111111111100000000000000000
111111111111111111100000100000111111111110000000111111111000111111111100000001111111111111111111111100000111111111111100000000000000000
111111111111111111133333333333111111111113111333111111133333111111111333331331111111111111111111111133333111111111111133333333333333333
111111111111111111111111111111111111111111111111111111111111111111111111111111111111111111111111111111111111111111111111111111111111111