000000000000000000000000000010000000000000000222000000000000000000000000000000000000000000000000000000000000000000000000000000000000000000000000000000000000000000022200000000060000000000000000000000000000
000000000000000000000000000011000002222200000000000020000000000000000000000000000000000000000222220000000000000000000000000222220000000000000000000000000222220000000000000000110000000000000000000000000000
000000000000000000000000000011000000000000000000000000000000000000000000000000000000000000000000000000000000000000000000000000000000000000000000000000000000000000000000000000110000000000000000000000000000
000000000000000000000000000011000000000000002200000030000000000000000000000000000220000200000000000000022000000220002200000000000002200000000220002200000000000000000000000000110000000000000000000000000000
000000000000000000000000000011000000000000021000000210000000000000000000000000000112000122233222000002211333322112331122222222200000000333322112331122222200000000000000000001110000000000000000000000000000
000000000000000000000000000011100000000000010000222110022000000000000000000000220111200111111111000021111111111111111111111111100000000111111111111111111100000002222000000001110000000000000000000000000000
000000000000000000000000000011110000330000013002111110000000000000000000022000000111100000000000000211111444441111111111111111144444444111111111111111111111100000100000001111110000000000000000000000000000
000000000000000000000000000011111111111111111221111110000000220000000220000000000111155555555555555111111444441111111111111111144444444111111111111111111111115555155555551111115555555555555555555555555555
000000000000000000000000000011111111111111111111111110000000000002200000000000000111111111111111111111111111111111111111111111111111111111111111111111111111111111111111111111114444444444444444444444444444
000006000111111111000000000011111111111111111111111110000000000000000000000000000111111111111111111111111111111111111111111111111111111111111111111111111111111111111111111111114444444444444444444444444444
444444444444444444444444444411111111111111111111111115555555555555555555555555555111111111111111111111111111111111111111111111111111111111111111111111111111111111111111111111114444444444444444444444444444
444444444444444444444444444411111111111111111111111114444444444444444444444444444111111111111111111111111111111111111111111111111111111111111111111111111111111111111111111111114444444444444444444444444444
444444444444444444444444444411111111111111111111111111111111111111111111111111111111111111111111111111111111111111111111111111111111111111111111111111111111111111111111111111114444444444444444444444444444